lvl,20,12,2015-05-12 20:45,marcus@grenangen.se,Marcus
00000000000000000000
00099999999900000000
00093334333999999000
00093533334433379000
00093833353999999000
00093133333900000000
00999999333999999000
00966669433466669000
00966669999966669000
00966669000966669000
00999999000999999000
00000000000000000000
