lvl,20,12,2015-05-12 20:45,marcus@grenangen.se,Marcus
22222222222222222222
23333433333436333332
23833463334444333432
23333433363333333432
22222222222222223632
23333443333333343332
23433363343336343332
23422222222222222222
26333334343336433332
23333443346333463347
23633334343343363342
22222222222222222222
