lvl,20,12,2015-05-25T12:11:08,,
00933335333333339000
00933399993333439000
00933333333333339000
00933333999933339000
00963333333333349000
00999933833999999000
00933333333333339000
00933339999933339000
00943339333933349000
00944339373933449000
00944449333934449000
00944449999944449000
